111111111111111111111
100000000010000000001
101110111010111011101
101110111010111011101
100000000000000000001
101110101111101011101
100000100010001000001
111110111010111011111
111110100000001011111
111110101101101011111
000000001000100000000
111110101000101011111
111110101111101011111
111110100000001011111
111110101111101011111
100000000010000000001
101110111010111011101
100010000000000010001
111010101111101010111
100000100010001000001
101111111010111111101
100000000000000000001
111111111111111111111